25
............................................................
............................................................
..................AC........................................
..................DEBBBBBC..................................
..................DEEEEEEF..................................
..................DEEEEEEF..................................
..................DEEEEEEF..................................
..................DEEEEEEF..................................
............................................................
........BBBBBBBBBBBBBBBBBBBBB......BBBBBBBBBBBBBBBBB.......B
........B..................................................B
........B..................................................B
........B.........BBBBBBBBBBBBBBBBBBBBBBBBBBBBBBBBBBBBBBB..B
........B...............................................B..B
........B...............................................B..B
........BBBBBBBBBBBBBBBBBBBBBBBBBBBBBBBBBBBBBBBBBBB.....B..B
..................................................B.....B..B
..................................................B.....B..B
...BBBBBBBBBBBBBBBBBBBBBBBBBBBBBBBBBBBBBBBBBBBBBBBB.....B..B
...B....................................................B..B
...B....................................................B..B
...B..........BBBBBBBBBBBBBBBBBBBBBBBBBBBBBBBBBBBBBBBBBBBB.B
...B.......................................................B
...B.......................................................B
QQQQQQQQQQQQQQQQQQQQQQQQQQQQQQQQQQQQQQQQQQQQQQQQQQQQQQQQQQQQ
18
1.png
2.png
3.png
4.png
5.png
6.png
7.png
8.png
9.png
10.png
11.png
12.png
13.png
14.png
15.png
16.png
17.png
18.png
BG.png